NO ./textures/north.xpm
SO ./textures/south.xpm
WE ./textures/west.xpm
EA ./textures/east.xpm
F 71,71,71   
C 0,0,1 

        1111111111111111111111111
        100D000000110000000000001
        1011000001110000000000001
        1001000000D00000000000001
111111111011000001110000000000001
100000000011000001110111111111111
11110111111111D11100000010001
1111D111111111011101010010001
110000001101010111000000D0001
10000000D00000001100000010001
10000000D00000001101010010001
11000001110101011111011110N0111
11110111 1110101 101111010001
11111111 1111111 111111111111