NO ./textures/north.xpm
SO ./textures/south.xpm
WE ./textures/west.xpm
EA ./textures/east.xpm

C 0,0,0
F 71 ,71, 71

1111111111111111111111111
1N00000001111000000000001
1011110101D01011111010101
100001010000100000001D001
1111010111101111110111101
1D00010000000000100000001
10111101111111111D1111101
1000000000100010000000001 
1110111010101010111011101
10001000101010D0000010001
101110101D100010101011101
1000100010101010100010001
1110111010101010111011101
10000000001D0010000000001
1011111111111111111111101
1000000000000000000000001
1111111111111111111111111